1111111111111
1cp0100000001
1000000000001
100C000000001
100C000000001
100C000000001
100011000e001
1111111111111