SO ./assets/green.xpm
NO ./assets/red.xpm
EA ./assets/purple.xpm
WE ./assets/blue.xpm
F 0,200,0
C 255,255,255

        1111111111111111111111111
        1000000000110000000000001
        1001000000000000000000001
        1001000000000000000000001
111111110110000011100000000000001
10000000001011101111101111111111  111  
11110111111111011100000010001     101  
11110111111111011101010010001    111
11000000110101011100000010001
10000000000000001000W0010001
10000000000000001101010010001
1100000110010101111101111000111
11110111 1110101 101111010001
11111111 1111111 111111111111
